ziyou	自由
zìjǐ	自己
yiti	一体
yiyang	一样
hǎoxiàng	好像
méiyou	没有
jiēchu	接触
zhouwéi	周围
mǎnyi	满意
qiguài	奇怪
wēixié	威胁
yīdiǎn	一点
jinháng	进行
shijiè	世界
pángbiān	旁边
jingshén	精神
ji院		妓院
仈jiu	八九
shíjiān	时间
yǐjīng	已经
jiān	奸
jiliè	激烈
zhīdào	知道
méiyǒu	没有
shíme	什么
rúguǒ	如果
nénggòu	能够
qíguài	奇怪
shíhòu	时候
dìfāng	地方
zhōuwéi	周围
fǎngfó	仿佛
jīngshén	精神
zhongyāng	zhong.*?yāng	zhongyang	中央
cāo	操
cháo	潮
nénggou	能够
guochéng	过程
sāo	骚
yu	欲
dd	弟弟
nàme	那么
xing	性
huángsè	黄色
shè	射
赤luo	赤裸
lǜsè	绿色
sè	色
duli	独立
ri	日
ru	乳


